Abendschule|evening school
Abfall|waste
Abgas|exhaust gas
Abschluss|graduation
Abstimmung|vote
Altbau|old building
Ampel|traffic light
Analyse|analysis
Angebot|offer
Angeklagte|defendant
Anwalt|lawyer
Anzeige|report
Arbeitgeber|employer
Arbeitnehmer|employee
Arbeitsamt|employment office
Arbeitsvertrag|employment contract
Argument|argument
Artenschutz|species protection
Ausbildung|apprenticeship
Auszug|extract
Autobahn|highway
Autor|author
Bachelor|bachelor's degree
Beförderung|promotion
Behandlung|treatment
Bekannte|acquaintance
Berufserfahrung|professional experience
Beschwerde|complaint
Besichtigung|visit
Bestseller|bestseller
Beweis|proof
Bewerbungsschreiben|cover letter
Bewältigung|coping
Beziehung|relationship
Biologie|biology
Blutprobe|blood test
Branche|industry
Burnout|burnout
Bußgeld|fine
Bürger|citizen
CO2-Ausstoß|CO2 emissions
Chemie|chemistry
Daten|data
Daumen drücken|to wish luck
Demokratie|democracy
Demonstration|demonstration
Denkmal|monument
Depression|depression
Diagnose|diagnosis
Dichter|poet
Diebstahl|theft
Diktatur|dictatorship
Diplom|diploma
Diskussion|discussion
Dokumentarfilm|documentary film
Drehbuch|screenplay
Eigentümer|owner
Einbahnstraße|one-way street
Einigung|agreement
Einzug|move-in
Entdeckung|discovery
Epoche|epoch
Erfindung|invention
Ergebnis|result
Erholung|recreation
Erinnerung|memory
Erzählung|story
Experiment|experiment
Export|export
Facharzt|specialist
Fahrgemeinschaft|carpool
Film|film
Forscher|researcher
Forschung|research
Fortbildung|further education
Freiheit|freedom
Freundschaft|friendship
Frieden|peace
Fähigkeit|ability
Führerschein|driver's license
Gedicht|poem
Gefängnis|prison
Gegenwart|present
Gehaltserhöhung|salary increase
Geldstrafe|fine
Gerechtigkeit|justice
Gericht|court
Geschichte|history
Geschwindigkeit|speed
Geschwindigkeitsbegrenzung|speed limit
Gesellschaft|society
Gesetz|law
Gewinn|profit
Gewohnheit|habit
Gleichheit|equality
Grenze|border
Grundriss|floor plan
Hals- und Beinbruch|break a leg
Handel|trade
Handlung|action
Hauptfigur|main character
Haushalt|household
Hautfarbe|skin color
Heimat|homeland
Heizung|heating
Herausforderung|challenge
Herkunft|origin
Herr|mister
Herzen|hearts
Herztöne|heartbeats
Hexe|witch
Hilfe|help
Hilflosigkeit|helplessness
Hilfsbereitschaft|willingness to help
Himmel|sky
Hingabe|devotion
Hindernis|obstacle
Hintergrund|background
Hinterlist|treachery
Hinweis|hint
Hirn|brain
Hitze|heat
Hobby|hobby
Hochachtung|respect
Hochbahn|elevated railway
Hochdeutsch|standard German
Hochebene|plateau
Hocherfreut|delighted
Hochfläche|highland
Hochfrequenz|high frequency
Hochgebirge|high mountains
Hochgeschwindigkeit|high speed
Hochglanz|high gloss
Hochhafen|main port
Hochhaus|skyscraper
Hochhochwasser|extreme flood
Hochkammer|upper chamber
Hochkapazität|high capacity
Hochkante|edge
Hochkirche|high church
Hochkonservativ|highly conservative
Hochkontrast|high contrast
Hochkonzentration|high concentration
Hochkonjunktur|boom
Hochkosten|high costs
Hochkultur|high culture
Hochlage|high position
Hochland|highlands
Hochlast|heavy load
Hochleistung|high performance
Hochleistungsfähig|high-performance
Hochleistungssport|high-performance sport
Hochmacht|high power
Hochmasse|high mass
Hochmeister|high master
Hochmessung|high measurement
Hochmeteorologie|high-altitude meteorology
Hochmild|mild
Hochmineral|high mineral
Hochmisere|high misery
Hochmisette|high mass
Hochmist|high manure
Hochmitter|high mitre
Hochmitglied|high member
Hochmittagsglut|midday heat
Hochmittel|high means
Hochmittelschule|secondary school
Hochmittelstand|upper middle class
Hochmittelwert|high average
Hochmitternacht|high midnight
Hochmitträger|high bearer
Hochmitre|high mitre
Hochmittrierung|high mitring
Hochmittsommer|high midsummer
Hochmode|high fashion
Hochmöglich|as high as possible
Hochmöglichkeit|high possibility
Hochmöglichst|as high as possible
Hochmöglichsten|as high as possible
winzig|tiny
zahlreich|numerous
türkis|turquoise
durchsichtig|transparent
trüb|turbid
matt|matte
glänzend|shiny
herrlich|magnificent
ausgezeichnet|excellent
optimal|optimal
wertvoll|valuable
zuverlässig|reliable
flink|agile
furchtbar|terrible
entsetzlich|horrible
veraltet|obsolete
chaotisch|chaotic
beschädigt|damaged
fehlerhaft|erroneous
riskant|risky
träge|sluggish
öde|monotonous
überflüssig|superfluous
warmherzig|warm-hearted
großzügig|generous
aufrichtig|sincere
loyal|loyal
verantwortlich|responsible
sorgfältig|careful
gelassen|calm
heiter|cheerful
lebhaft|lively
energisch|energetic
dynamisch|dynamic
geschickt|skillful
talentiert|talented
begabt|gifted
fantasievoll|imaginative
aufgeschlossen|open-minded
tolerant|tolerant
tapfer|brave
selbstbewusst|self-confident
selbstständig|independent
unabhängig|independent
bescheiden|modest
zurückhaltend|reserved
introvertiert|introverted
extrovertiert|extroverted
kontaktfreudig|sociable
gesellig|social
gesprächig|talkative
egoistisch|selfish
arrogant|arrogant
eingebildet|conceited
stur|stubborn
hartnäckig|persistent
launisch|moody
nachlässig|negligent
unzuverlässig|unreliable
aggressiv|aggressive
gewalttätig|violent
erfreut|delighted
erstaunt|astonished
deprimiert|depressed
niedergeschlagen|downhearted
frustriert|frustrated
zornig|angry
verärgert|annoyed
verängstigt|frightened
panisch|panicky
erschöpft|exhausted
nostalgisch|nostalgic
neidisch|envious
eifersüchtig|jealous
schuldig|guilty
beschämt|ashamed
erleichtert|relieved
hoffnungsvoll|hopeful
gleichgültig|indifferent
empört|outraged
schockiert|shocked
klimatisch|climatic
mild|mild
hageln|to hail
wehen|to blow
stürmisch|stormy
frostig|frosty
eisig|icy
feucht|humid
schwül|sultry
gefrieren|to freeze
der Schauer|the shower
der Orkan|the hurricane
der Tornado|the tornado
der Frost|the frost
die Feuchtigkeit|the humidity
die Dürre|the drought
die Überschwemmung|the flood
der Regenschauer|the rain shower
der Nieselregen|the drizzle
der Schneefall|the snowfall
der Schneesturm|the snowstorm
die Luftfeuchtigkeit|the humidity
der Luftdruck|the air pressure
die Hitzewelle|the heat wave
die Kältewelle|the cold wave
die Naturkatastrophe|the natural disaster
das Erdbeben|the earthquake
umweltfreundlich|environmentally friendly
umweltschädlich|environmentally harmful
der Umweltschutz|the environmental protection
die Ökologie|the ecology
ökologisch|ecological
das Ökosystem|the ecosystem
der Naturschutz|the nature conservation
das Naturschutzgebiet|the nature reserve
die Nachhaltigkeit|the sustainability
nachhaltig|sustainable
die Verschmutzung|the pollution
verschmutzen|to pollute
verschmutzt|polluted
die Luftverschmutzung|the air pollution
die Wasserverschmutzung|the water pollution
der Smog|the smog
das Kohlendioxid|the carbon dioxide
das CO2|the CO2
der Treibhauseffekt|the greenhouse effect
das Treibhausgas|the greenhouse gas
der Klimawandel|the climate change
die Klimakrise|the climate crisis
die Erderwärmung|the global warming
die globale Erwärmung|the global warming
das Ozonloch|the ozone hole
der Hausmüll|the household waste
der Plastikmüll|the plastic waste
wiederverwerten|to recycle
die Wiederverwertung|the recycling
die Mülltrennung|the waste separation
der Biomüll|the organic waste
die Verpackung|the packaging
verpacken|to package
wiederverwendbar|reusable
die Umweltverschmutzung|the environmental pollution
die Abgase|the exhaust gases
die Einwegflasche|the single-use bottle
die Mehrwegflasche|the reusable bottle
das Pfand|the deposit
die Elektrizität|the electricity
das Kraftwerk|the power plant
das Atomkraftwerk|the nuclear power plant
das Kernkraftwerk|the nuclear power plant
die Atomenergie|the nuclear energy
die Kernenergie|the nuclear energy
nuklear|nuclear
das Kohlekraftwerk|the coal power plant
die Kohle|the coal
das Erdöl|the crude oil
das Erdgas|the natural gas
der fossile Brennstoff|the fossil fuel
fossil|fossil
erneuerbar|renewable
die erneuerbare Energie|the renewable energy
die Solarenergie|the solar energy
die Sonnenenergie|the solar energy
die Solarzelle|the solar cell
das Solarpanel|the solar panel
die Windenergie|the wind energy
das Windrad|the wind turbine
die Wasserkraft|the hydropower
der Energieverbrauch|the energy consumption
der Verbrauch|the consumption
der Stromausfall|the power outage
das Stromnetz|the power grid
die Ladestation|the charging station
tierisch|animal
pflanzlich|plant
die Art|the species
die Tierart|the animal species
die Pflanzenart|the plant species
die Artenvielfalt|the species diversity
die Biodiversität|the biodiversity
das Aussterben|the extinction
aussterben|to become extinct
ausgestorben|extinct
bedroht|threatened
die bedrohte Art|the endangered species
gefährdet|endangered
der Tierschutz|the animal protection
das Wildtier|the wildlife
der Lebensraum|the habitat
der Regenwald|the rainforest
der Urwald|the primeval forest
die Abholzung|the deforestation
abholzen|to deforest
das Wachstum|the growth
verwelken|to wilt
der Samen|the seed
die Hecke|the hedge
das Moos|the moss
die Alge|the algae
das Riff|the reef
das Korallenriff|the coral reef
die Landwirtschaft|the agriculture
landwirtschaftlich|agricultural
der Landwirt|the farmer
die Landwirtin|the farmer
säen|to sow
die Saat|the seed
pflügen|to plow
düngen|to fertilize
der Dünger|the fertilizer
das Pestizid|the pesticide
die Viehzucht|the livestock farming
das Vieh|the livestock
züchten|to breed
die Zucht|the breeding
die Scheune|the barn
das Getreide|the grain
der Mais|the corn
der Weizen|the wheat
die Gerste|the barley
der Hafer|the oats
der Reis|the rice
die Kartoffel|the potato
die Rübe|the beet
der Kohl|the cabbage
der Spinat|the spinach
die Bohne|the bean
die Erbse|the pea
die Gurke|the cucumber
die Tomate|the tomato
der Apfel|the apple
die Birne|the pear
der Pfirsich|the peach
die Kirsche|the cherry
die Erdbeere|the strawberry
die Himbeere|the raspberry
die Brombeere|the blackberry
die Johannisbeere|the currant
die Stachelbeere|the gooseberry
die Blaubeere|the blueberry
die Preiselbeere|the lingonberry
der Fisch|the fish
der Hecht|the pike
die Forelle|the trout
der Karpfen|the carp
der Hering|the herring
die Makrele|the mackerel
die Sardine|the sardine
der Kabeljau|the cod
der Aal|the eel
der Vogel|the bird
der Adler|the eagle
der Falke|the falcon
die Eule|the owl
der Rabe|the raven
die Krähe|the crow
die Taube|the dove
der Sperling|the sparrow
die Schwalbe|the swallow
die Lerche|the lark
der Fink|the finch
der Kanarienvogel|the canary
der Papagei|the parrot
der Storch|the stork
der Kranich|the crane
der Reiher|the heron
der Flamingo|the flamingo
der Pinguin|the penguin
der Strauß|the ostrich
die Gans|the goose
die Ente|the duck
der Schwan|the swan
der Hahn|the rooster
die Henne|the hen
die Kücken|the chick
der Truthahn|the turkey
das Huhn|the chicken
der Hund|the dog
die Katze|the cat
das Pferd|the horse
die Kuh|the cow
der Stier|the bull
der Bulle|the bull
das Kalb|the calf
die Sau|the sow
das Schwein|the pig
das Ferkel|the piglet
das Schaf|the sheep
der Hammel|the wether
das Lamm|the lamb
die Ziege|the goat
der Esel|the donkey
das Maultier|the mule
das Kamel|the camel
die Giraffe|the giraffe
der Elefant|the elephant
das Nashorn|the rhinoceros
das Nilpferd|the hippopotamus
der Löwe|the lion
die Löwin|the lioness
der Tiger|the tiger
der Leopard|the leopard
der Panther|the panther
der Bär|the bear
der Eisbär|the polar bear
der Panda|the panda
der Wolf|the wolf
der Fuchs|the fox
der Dachs|the badger
der Otter|the otter
der Marder|the marten
das Wiesel|the weasel
das Eichhörnchen|the squirrel
das Murmeltier|the groundhog
der Hamster|the hamster
die Maus|the mouse
die Ratte|the rat
der Igel|the hedgehog
der Frosch|the frog
die Kröte|the toad
der Molch|the newt
die Schlange|the snake
die Viper|the viper
die Eidechse|the lizard
die Schildkröte|the turtle
das Krokodil|the crocodile
der Alligator|the alligator
die Biene|the bee
die Honigbiene|the honey bee
die Drohne|the drone
die Wespe|the wasp
die Hornisse|the hornet
die Mücke|the mosquito
die Fliege|the fly
die Schmetterlinge|the butterfly
die Motte|the moth
die Libelle|the dragonfly
die Heuschrecke|the locust
die Grille|the cricket
die Zikade|the cicada
die Läuse|the lice
der Floh|the flea
der Käfer|the beetle
der Mistkäfer|the dung beetle
der Hirschkäfer|the stag beetle
der Marienkäfer|the ladybird
die Schnecke|the snail
die Nacktschnecke|the slug
der Regenwurm|the earthworm
die Spinne|the spider
die Spinnennetze|the spider web
der Skorpion|the scorpion
die Luft|the air
das Wasser|the water
das Feuer|the fire
die Erde|the earth
der Stein|the stone
der Felsen|the rock
der Berg|the mountain
der Hügel|the hill
das Tal|the valley
die Ebene|the plain
die Wiese|the meadow
das Feld|the field
der Wald|the forest
der Baum|the tree
der Strauch|the shrub
der Busch|the bush
die Blume|the flower
die Rose|the rose
die Tulpe|the tulip
die Narzisse|the daffodil
die Pflanze|the plant
das Kraut|the herb
das Gras|the grass
der Klee|the clover
der Pilz|the mushroom
der Fluss|the river
der Bach|the stream
der See|the lake
das Meer|the sea
der Strand|the beach
die Küste|the coast
die Bucht|the bay
der Golf|the gulf
das Delta|the delta
die Insel|the island
die Halbinsel|the peninsula
der Hafen|the port
die Quelle|the source
der Brunnen|the well
die Wasserleitung|the water pipe
die Kanalisation|the sewage system
der Kanal|the canal
die Schleuse|the lock
der Damm|the dam
der Deich|the dike
das Loch|the hole
die Grube|the pit
der Stollen|the tunnel
der Schacht|the shaft
die Höhle|the cave
die Grotte|the grotto
der Schlund|the chasm
die Schlucht|the gorge
die Spalte|the crevasse
der Riss|the crack
der Sprung|the fracture
die Bruch|the fracture
der Bruchstein|the rubble
der Kies|the gravel
der Sand|the sand
der Schlamm|the mud
der Ton|the clay
die Tonerde|the clay
die Mulch|the mulch
der Humus|the humus
